anjani.kumar@anjani example % npx ts-node index.ts
{
  getNodeCount: [Function: getNodeCount],
  getIdentifierCount: [Function: getIdentifierCount],
  getSymbolCount: [Function: getSymbolCount],
  getTypeCount: [Function: getTypeCount],
  getInstantiationCount: [Function: getInstantiationCount],
  getRelationCacheSizes: [Function: getRelationCacheSizes],
  isUndefinedSymbol: [Function: isUndefinedSymbol],
  isArgumentsSymbol: [Function: isArgumentsSymbol],
  isUnknownSymbol: [Function: isUnknownSymbol],
  getMergedSymbol: [Function: getMergedSymbol],
  getDiagnostics: [Function: getDiagnostics],
  getGlobalDiagnostics: [Function: getGlobalDiagnostics],
  getRecursionIdentity: [Function: getRecursionIdentity],
  getUnmatchedProperties: [Function: getUnmatchedProperties],
  getTypeOfSymbolAtLocation: [Function: getTypeOfSymbolAtLocation],
  getTypeOfSymbol: [Function: getTypeOfSymbol],
  getSymbolsOfParameterPropertyDeclaration: [Function: getSymbolsOfParameterPropertyDeclaration],
  getDeclaredTypeOfSymbol: [Function: getDeclaredTypeOfSymbol],
  getPropertiesOfType: [Function: getPropertiesOfType],
  getPropertyOfType: [Function: getPropertyOfType],
  getPrivateIdentifierPropertyOfType: [Function: getPrivateIdentifierPropertyOfType],
  getTypeOfPropertyOfType: [Function: getTypeOfPropertyOfType],
  getIndexInfoOfType: [Function: getIndexInfoOfType],
  getIndexInfosOfType: [Function: getIndexInfosOfType],
  getIndexInfosOfIndexSymbol: [Function: getIndexInfosOfIndexSymbol],
  getSignaturesOfType: [Function: getSignaturesOfType],
  getIndexTypeOfType: [Function: getIndexTypeOfType],
  getIndexType: [Function: getIndexType],
  getBaseTypes: [Function: getBaseTypes],
  getBaseTypeOfLiteralType: [Function: getBaseTypeOfLiteralType],
  getWidenedType: [Function: getWidenedType],
  getTypeFromTypeNode: [Function: getTypeFromTypeNode],
  getParameterType: [Function: getTypeAtPosition],
  getParameterIdentifierNameAtPosition: [Function: getParameterIdentifierNameAtPosition],
  getPromisedTypeOfPromise: [Function: getPromisedTypeOfPromise],
  getAwaitedType: [Function: getAwaitedType],
  getReturnTypeOfSignature: [Function: getReturnTypeOfSignature],
  isNullableType: [Function: isNullableType],
  getNullableType: [Function: getNullableType],
  getNonNullableType: [Function: getNonNullableType],
  getNonOptionalType: [Function: removeOptionalTypeMarker],
  getTypeArguments: [Function: getTypeArguments],
  typeToTypeNode: [Function: typeToTypeNode],
  indexInfoToIndexSignatureDeclaration: [Function: indexInfoToIndexSignatureDeclaration],
  signatureToSignatureDeclaration: [Function: signatureToSignatureDeclaration],
  symbolToEntityName: [Function: symbolToEntityName],
  symbolToExpression: [Function: symbolToExpression],
  symbolToNode: [Function: symbolToNode],
  symbolToTypeParameterDeclarations: [Function: symbolToTypeParameterDeclarations],
  symbolToParameterDeclaration: [Function: symbolToParameterDeclaration],
  typeParameterToDeclaration: [Function: typeParameterToDeclaration],
  getSymbolsInScope: [Function: getSymbolsInScope],
  getSymbolAtLocation: [Function: getSymbolAtLocation],
  getIndexInfosAtLocation: [Function: getIndexInfosAtLocation],
  getShorthandAssignmentValueSymbol: [Function: getShorthandAssignmentValueSymbol],
  getExportSpecifierLocalTargetSymbol: [Function: getExportSpecifierLocalTargetSymbol],
  getExportSymbolOfSymbol: [Function: getExportSymbolOfSymbol],
  getTypeAtLocation: [Function: getTypeAtLocation],
  getTypeOfAssignmentPattern: [Function: getTypeOfAssignmentPattern],
  getPropertySymbolOfDestructuringAssignment: [Function: getPropertySymbolOfDestructuringAssignment],
  signatureToString: [Function: signatureToString],
  typeToString: [Function: typeToString],
  symbolToString: [Function: symbolToString],
  typePredicateToString: [Function: typePredicateToString],
  writeSignature: [Function: writeSignature],
  writeType: [Function: writeType],
  writeSymbol: [Function: writeSymbol],
  writeTypePredicate: [Function: writeTypePredicate],
  getAugmentedPropertiesOfType: [Function: getAugmentedPropertiesOfType],
  getRootSymbols: [Function: getRootSymbols],
  getSymbolOfExpando: [Function: getSymbolOfExpando],
  getContextualType: [Function: getContextualType],
  getContextualTypeForObjectLiteralElement: [Function: getContextualTypeForObjectLiteralElement],
  getContextualTypeForArgumentAtIndex: [Function: getContextualTypeForArgumentAtIndex],
  getContextualTypeForJsxAttribute: [Function: getContextualTypeForJsxAttribute],
  isContextSensitive: [Function: isContextSensitive],
  getTypeOfPropertyOfContextualType: [Function: getTypeOfPropertyOfContextualType],
  getFullyQualifiedName: [Function: getFullyQualifiedName],
  getResolvedSignature: [Function: getResolvedSignature],
  getResolvedSignatureForStringLiteralCompletions: [Function: getResolvedSignatureForStringLiteralCompletions],
  getResolvedSignatureForSignatureHelp: [Function: getResolvedSignatureForSignatureHelp],
  getExpandedParameters: [Function: getExpandedParameters],
  hasEffectiveRestParameter: [Function: hasEffectiveRestParameter],
  containsArgumentsReference: [Function: containsArgumentsReference],
  getConstantValue: [Function: getConstantValue],
  isValidPropertyAccess: [Function: isValidPropertyAccess],
  isValidPropertyAccessForCompletions: [Function: isValidPropertyAccessForCompletions],
  getSignatureFromDeclaration: [Function: getSignatureFromDeclaration],
  isImplementationOfOverload: [Function: isImplementationOfOverload],
  getImmediateAliasedSymbol: [Function: getImmediateAliasedSymbol],
  getAliasedSymbol: [Function: resolveAlias],
  getEmitResolver: [Function: getEmitResolver],
  getExportsOfModule: [Function: getExportsOfModuleAsArray],
  getExportsAndPropertiesOfModule: [Function: getExportsAndPropertiesOfModule],
  forEachExportAndPropertyOfModule: [Function: forEachExportAndPropertyOfModule],
  getSymbolWalker: [Function: getSymbolWalker],
  getAmbientModules: [Function: getAmbientModules],
  getJsxIntrinsicTagNamesAt: [Function: getJsxIntrinsicTagNamesAt],
  isOptionalParameter: [Function: isOptionalParameter],
  tryGetMemberInModuleExports: [Function: tryGetMemberInModuleExports],
  tryGetMemberInModuleExportsAndProperties: [Function: tryGetMemberInModuleExportsAndProperties],
  tryFindAmbientModule: [Function: tryFindAmbientModule],
  tryFindAmbientModuleWithoutAugmentations: [Function: tryFindAmbientModuleWithoutAugmentations],
  getApparentType: [Function: getApparentType],
  getUnionType: [Function: getUnionType],
  isTypeAssignableTo: [Function: isTypeAssignableTo],
  createAnonymousType: [Function: createAnonymousType],
  createSignature: [Function: createSignature],
  createSymbol: [Function: createSymbol],
  createIndexInfo: [Function: createIndexInfo],
  getAnyType: [Function: getAnyType],
  getStringType: [Function: getStringType],
  getNumberType: [Function: getNumberType],
  createPromiseType: [Function: createPromiseType],
  createArrayType: [Function: createArrayType],
  getElementTypeOfArrayType: [Function: getElementTypeOfArrayType],
  getBooleanType: [Function: getBooleanType],
  getFalseType: [Function: getFalseType],
  getTrueType: [Function: getTrueType],
  getVoidType: [Function: getVoidType],
  getUndefinedType: [Function: getUndefinedType],
  getNullType: [Function: getNullType],
  getESSymbolType: [Function: getESSymbolType],
  getNeverType: [Function: getNeverType],
  getOptionalType: [Function: getOptionalType],
  getPromiseType: [Function: getPromiseType],
  getPromiseLikeType: [Function: getPromiseLikeType],
  getAsyncIterableType: [Function: getAsyncIterableType],
  isSymbolAccessible: [Function: isSymbolAccessible],
  isArrayType: [Function: isArrayType],
  isTupleType: [Function: isTupleType],
  isArrayLikeType: [Function: isArrayLikeType],
  isTypeInvalidDueToUnionDiscriminant: [Function: isTypeInvalidDueToUnionDiscriminant],
  getExactOptionalProperties: [Function: getExactOptionalProperties],
  getAllPossiblePropertiesOfTypes: [Function: getAllPossiblePropertiesOfTypes],
  getSuggestedSymbolForNonexistentProperty: [Function: getSuggestedSymbolForNonexistentProperty],
  getSuggestionForNonexistentProperty: [Function: getSuggestionForNonexistentProperty],
  getSuggestedSymbolForNonexistentJSXAttribute: [Function: getSuggestedSymbolForNonexistentJSXAttribute],
  getSuggestedSymbolForNonexistentSymbol: [Function: getSuggestedSymbolForNonexistentSymbol],
  getSuggestionForNonexistentSymbol: [Function: getSuggestionForNonexistentSymbol],
  getSuggestedSymbolForNonexistentModule: [Function: getSuggestedSymbolForNonexistentModule],
  getSuggestionForNonexistentExport: [Function: getSuggestionForNonexistentExport],
  getSuggestedSymbolForNonexistentClassMember: [Function: getSuggestedSymbolForNonexistentClassMember],
  getBaseConstraintOfType: [Function: getBaseConstraintOfType],
  getDefaultFromTypeParameter: [Function: getDefaultFromTypeParameter],
  resolveName: [Function: resolveName],
  getJsxNamespace: [Function: getJsxNamespace],
  getJsxFragmentFactory: [Function: getJsxFragmentFactory],
  getAccessibleSymbolChain: [Function: getAccessibleSymbolChain],
  getTypePredicateOfSignature: [Function: getTypePredicateOfSignature],
  resolveExternalModuleName: [Function: resolveExternalModuleName],
  resolveExternalModuleSymbol: [Function: resolveExternalModuleSymbol],
  tryGetThisTypeAt: [Function: tryGetThisTypeAt],
  getTypeArgumentConstraint: [Function: getTypeArgumentConstraint],
  getSuggestionDiagnostics: [Function: getSuggestionDiagnostics],
  runWithCancellationToken: [Function: runWithCancellationToken],
  getLocalTypeParametersOfClassOrInterfaceOrTypeAlias: [Function: getLocalTypeParametersOfClassOrInterfaceOrTypeAlias],
  isDeclarationVisible: [Function: isDeclarationVisible],
  isPropertyAccessible: [Function: isPropertyAccessible],
  getTypeOnlyAliasDeclaration: [Function: getTypeOnlyAliasDeclaration],
  getMemberOverrideModifierStatus: [Function: getMemberOverrideModifierStatus],
  isTypeParameterPossiblyReferenced: [Function: isTypeParameterPossiblyReferenced]
}